WWWWWWWWWWWWWWWWW
WW    WWWOWW    W
WW  W1WWW1WW1W 1W
WW1 W1WWW1WW WWWW
WWWWW    1   WWWW
WW          WWWWW
WW              W
WWW WW      WW 1W
W   WW      WW  W
W 1 WW1      WWWW
W1  WWRWWGW BWWWW
WWWWWWWWWWWWWWWWW 