WWWWWWWWWWWWWWWWWWWWWWWWWWWWWWWWW
W         W        WOW          W
W   R  t  W        WHW          W
W         W        WYW          W
WWWWWWWWNWW                     W
W                               W
W   h                           W
W                        WWWWWWWW
W                        W  G   W
W                        W    y W
W       B                W    n W
W                        T      W
WWWWWWWWWWWWWWWWWWWWWWWWWWWWWWWWW