WWWWWWWWWWWWWWWW
W   34 W 2W W BW
W1 WWW W  W 2  W
WWWWWW W1WW W1 W
W           WWWW
WWWW        12OW
W  1        WWWW
W  W        WWWW
W2 W  W3W   1  W
WWWW   11   W GW
WWWWWWWWWWWWWWWW