WWWWWWWWWWWWWWWWW
WW    WWWOWW    W
WW  WHWWWMWWNW yW
WWm WTWWWYWW WWWW
WWWWW    C   WWWW
WW          WWWWW
WW              W
WWW WW      WW hW
W   WW      WW  W
W n WWc      WWWW
Wt  WWRWWGW BWWWW
WWWWWWWWWWWWWWWWW 