WWWWWWWWWWWWWWWW
W   tt W hW W BW
Wt WWW W  W T  W
WWWWWW WHWW Wn W
W R         WWWW
WWWW        CHOW
W  N        WWWW
W  W        WWWW
Wt W  WhW   T  W
WWWW   ch   W GW
WWWWWWWWWWWWWWWW