WWWWWWWWWWWWWWWW
WWR W   WOWn  WW
WWW W   WMW  WWW
W t W WWW WW  WW
WtWWW t NmH B WW
W W W WWWWWWW WW
WtW W   h Wn n W
W   tW WYWWTnWWW
WWWWCW W WW  nnW
WW   W    WWWW W
W W    W  WW  nW
W  tW   W WW WWW
W WW  WWW nCc  W
W yW  W   WW   W
WW    W  WWW  GW
WWWWWWWWWWWWWWWW